"","Country","Short","ID","Gold","Silver","Bronze","Total"
"1","Afghanistan","AFG","14","0","0","2","2"
"2","Algeria","ALG","13","5","4","8","17"
"3","Argentina","ARG","24","21","25","28","74"
"4","Armenia","ARM","6","2","6","6","14"
"5","Australasia","ANZ","2","3","4","5","12"
"6","Australia","AUS","26","147","163","187","497"
"7","Austria","AUT","27","18","33","36","87"
"8","Azerbaijan","AZE","6","7","11","24","42"
"9","Bahamas","BAH","16","6","2","6","14"
"10","Bahrain","BRN","9","2","1","0","3"
"11","Barbados","BAR","12","0","0","1","1"
"12","Belarus","BLR","6","12","27","39","78"
"13","Belgium","BEL","26","40","53","55","148"
"14","Bermuda","BER","18","0","0","1","1"
"15","Bohemia","BOH","3","0","1","3","4"
"16","Botswana","BOT","10","0","1","0","1"
"17","Brazil","BRA","22","30","36","63","129"
"18","British West Indies","BWI","1","0","0","2","2"
"19","Bulgaria","BUL","20","51","87","80","218"
"20","Burundi","BDI","6","1","1","0","2"
"21","Cameroon","CMR","14","3","1","2","6"
"22","Canada","CAN","26","64","102","136","302"
"23","Chile","CHI","23","2","7","4","13"
"24","China","CHN","10","224","167","155","546"
"25","Colombia","COL","19","5","9","14","28"
"26","Costa Rica","CRC","15","1","1","2","4"
"27","Ivory Coast","CIV","13","1","1","1","3"
"28","Croatia","CRO","7","11","10","12","33"
"29","Cuba","CUB","20","78","68","80","226"
"30","Cyprus","CYP","10","0","1","0","1"
"31","Czech Republic","CZE","6","15","17","24","56"
"32","Czechoslovakia","TCH","16","49","49","45","143"
"33","Denmark","DEN","27","45","74","75","194"
"34","Djibouti","DJI","8","0","0","1","1"
"35","Dominican Republic","DOM","14","3","2","2","7"
"36","Ecuador","ECU","14","1","1","0","2"
"37","Egypt","EGY","22","7","10","15","32"
"38","Eritrea","ERI","5","0","0","1","1"
"39","Estonia","EST","12","9","9","16","34"
"40","Ethiopia","ETH","13","22","11","21","54"
"41","Fiji","FIJ","14","1","0","0","1"
"42","Finland","FIN","25","101","85","117","303"
"43","France","FRA","28","212","241","263","716"
"44","Gabon","GAB","10","0","1","0","1"
"45","Georgia","GEO","6","8","7","17","32"
"46","Germany","GER","16","191","194","230","615"
"47","United Team of Germany","EUA","3","28","54","36","118"
"48","East Germany","GDR","5","153","129","127","409"
"49","West Germany","FRG","5","56","67","81","204"
"50","Ghana","GHA","14","0","1","3","4"
"51","Great Britain","GBR","28","263","295","293","851"
"52","Greece","GRE","28","33","43","40","116"
"53","Grenada","GRN","9","1","1","0","2"
"54","Guatemala","GUA","14","0","1","0","1"
"55","Guyana","GUY","17","0","0","1","1"
"56","Haiti","HAI","15","0","1","1","2"
"57","Hong Kong","HKG","16","1","1","1","3"
"58","Hungary","HUN","26","175","147","169","491"
"59","Iceland","ISL","20","0","2","2","4"
"60","India","IND","24","9","7","12","28"
"61","Indonesia","INA","15","7","13","12","32"
"62","Iran","IRI","16","21","21","27","69"
"63","Iraq","IRQ","14","0","0","1","1"
"64","Ireland","IRL","21","9","10","12","31"
"65","Israel","ISR","16","1","1","7","9"
"66","Italy","ITA","27","206","178","193","577"
"67","Jamaica","JAM","17","22","35","21","78"
"68","Japan","JPN","22","142","136","161","439"
"69","Jordan","JOR","10","1","0","0","1"
"70","Kazakhstan","KAZ","6","15","21","27","63"
"71","Kenya","KEN","14","31","38","34","103"
"72","Kosovo","KOS","1","1","0","0","1"
"73","North Korea","PRK","10","16","16","22","54"
"74","South Korea","KOR","17","90","87","90","267"
"75","Kuwait","KUW","12","0","0","2","2"
"76","Kyrgyzstan","KGZ","6","0","1","3","4"
"77","Latvia","LAT","11","3","11","5","19"
"78","Lebanon","LIB","17","0","2","2","4"
"79","Liechtenstein","LIE","17","0","0","0","0"
"80","Lithuania","LTU","9","6","6","13","25"
"81","Luxembourg","LUX","23","1","1","0","2"
"82","Macedonia","MKD","6","0","0","1","1"
"83","Malaysia","MAS","13","0","7","4","11"
"84","Mauritius","MRI","9","0","0","1","1"
"85","Mexico","MEX","23","13","24","32","69"
"86","Moldova","MDA","6","0","2","3","5"
"87","Mongolia","MGL","13","2","10","14","26"
"88","Montenegro","MNE","3","0","1","0","1"
"89","Morocco","MAR","14","6","5","12","23"
"90","Mozambique","MOZ","10","1","0","1","2"
"91","Namibia","NAM","7","0","4","0","4"
"92","Netherlands","NED","26","85","92","108","285"
"93","Netherlands Antilles","AHO","13","0","1","0","1"
"94","New Zealand","NZL","23","46","27","44","117"
"95","Niger","NIG","12","0","1","1","2"
"96","Nigeria","NGR","16","3","10","12","25"
"97","Norway","NOR","25","56","49","47","152"
"98","Pakistan","PAK","17","3","3","4","10"
"99","Panama","PAN","17","1","0","2","3"
"100","Paraguay","PAR","12","0","1","0","1"
"101","Peru","PER","18","1","3","0","4"
"102","Philippines","PHI","21","0","3","7","10"
"103","Poland","POL","21","68","84","132","284"
"104","Portugal","POR","24","4","8","12","24"
"105","Puerto Rico","PUR","18","1","2","6","9"
"106","Qatar","QAT","9","0","1","4","5"
"107","Romania","ROU","21","89","95","122","306"
"108","Russia","RUS","6","148","125","153","426"
"109","Russian Empire",NA,"3","1","4","3","8"
"110","Soviet Union","URS","9","395","319","296","1,010"
"111","Unified Team","EUN","1","45","38","29","112"
"112","Olympic Athletes from Russia","OAR","0","0","0","0","0"
"113","Saudi Arabia","KSA","11","0","1","2","3"
"114","Samoa","SAM","9","0","1","0","1"
"115","Senegal","SEN","14","0","1","0","1"
"116","Serbia","SRB","4","3","6","6","15"
"117","Serbia and Montenegro","SCG","1","0","2","0","2"
"118","Singapore","SIN","16","1","2","2","5"
"119","Slovakia","SVK","6","9","12","7","28"
"120","Slovenia","SLO","7","5","8","10","23"
"121","South Africa","RSA","19","26","31","29","86"
"122","Spain","ESP","23","45","64","41","150"
"123","Sri Lanka","SRI","17","0","2","0","2"
"124","Sudan","SUD","12","0","1","0","1"
"125","Suriname","SUR","12","1","0","1","2"
"126","Sweden","SWE","27","145","170","179","494"
"127","Switzerland","SUI","28","50","75","67","192"
"128","Syria","SYR","13","1","1","1","3"
"129","Chinese Taipei","TPE","14","5","7","12","24"
"130","Tajikistan","TJK","6","1","1","2","4"
"131","Tanzania","TAN","13","0","2","0","2"
"132","Thailand","THA","16","9","8","16","33"
"133","Togo","TOG","10","0","0","1","1"
"134","Tonga","TGA","9","0","1","0","1"
"135","Trinidad and Tobago","TTO","17","3","5","11","19"
"136","Tunisia","TUN","14","4","2","7","13"
"137","Turkey","TUR","22","39","24","28","91"
"138","Uganda","UGA","15","2","3","2","7"
"139","Ukraine","UKR","6","34","30","56","120"
"140","United Arab Emirates","UAE","9","1","0","1","2"
"141","United States","USA","27","1,022","795","705","2,522"
"142","Uruguay","URU","21","2","2","6","10"
"143","Uzbekistan","UZB","6","7","6","18","31"
"144","Venezuela","VEN","18","2","4","9","15"
"145","Vietnam","VIE","15","1","3","0","4"
"146","Virgin Islands","ISV","12","0","1","0","1"
"147","Yugoslavia","YUG","18","28","31","31","90"
"148","Zambia","ZAM","13","0","1","1","2"
"149","Zimbabwe","ZIM","13","3","4","1","8"
"150","Independent Olympic Athletes","IOA","3","1","0","1","2"
"151","Independent Olympic Participants","IOP","1","0","1","2","3"
"152","Mixed team","ZZX","3","8","5","4","17"
